50;pink;
#####################.......######################
############.....###..............################
###########.......#.................##############
##########.............###...........#############
#####.................#####............###########
####.........###.....#######..####......##########
###.........#####....##############......#########
###.........########################......########
###...###..###########################....########
###....###############################....########
###................##........##..........#########
####................#........#...........#########
#####...............#........#..........##########
######..............#........#........############
#######...######....#...##...#....#....###########
######....######....#...##...#....#....###########
######....######....#...##...#....#...############
######....######........##...#....#..........#####
######....#######.FFFF.###...#....#...........####
######....########....####...#....#............###
######....################...#....#............###
######....################...#....#...######...###
######....####OOO####OOO##...#....#....#####...###
######....####OOOO###OOO##...#....#....#####...###
######....####OOOO###OOO##...#....#....#####...###
######....####OOOO###OOO##...#....#....####....###
######....####OOOO###OOO##........#....####....###
######....####OOOO###OOO##.......##....####....###
######....####OOOO###OOO###.....###....####...####
######....####OOOO###OOO####...####....###....####
######....####OOOO###OOO####...####....###....####
######....####OOOO###OOO####...####....##....#####
######....####OOOO###OOO####...####....##....#####
######....####OOOO###OOO####...####....#....######
######....####OOOO###OOO####...####...#.....######
######....####OOOO###OOO####...####........#######
######....####OOOO###OOO####...####.......########
######....####OOOO###OOO####...####......#########
######....####OOOO###OOO####...####.....##########
######....####OOOO###OOO####...####....###########
######....####OOOO###OOO####...####...############
######....####OOO####OOO####...####....###########
######....#########################....###########
######....#########################....###########
######....#########################....###########
######....#########################....###########
#######....#######################....############
#######...............................############
########..............P..............#############
#########...........................##############

